11111111111111111111111111111-
10001000100010001111111111111-
10101010101010101111111111111-
10101010101010101111111111111-
10101010101010101111111111111-
10101010101010101111111111111-
10101010101010101111111111111-
10101010101010101111111111111-
10100010001000100011111111111-
11111111111111111111111111111-
11111111111111111111111111111-
11111111111111111111111111111-
11111111111111111111111111111-
11111111111111111111111111111-
11111111111111111111111111111