22222222222222222222222222222-
21112111211121112222222222222-
21212121212121212222222222222-
21212121212121212222222222222-
21212121212121212222222222222-
21212121212121212222222222222-
21212121212121212222222222222-
21212121212121212222222222222-
21211121112111211122222222222-
22222222222222222222222222222-
22222222222222222222222222222-
22222222222222222222222222222-
22222222222222222222222222222-
22222222222222222222222222222-
22222222222222222222222222222